[
    [0,0,0,0,0,0,0,0,0,0,0,0,0,0],
    [0,0,0,0,0,0,0,0,0,0,0,0,1,2],
    [0,0,0,0,0,0,0,0,0,0,0,0,0,2],
    [0,0,0,0,0,0,0,0,0,0,0,0,0,2],
    [0,0,0,0,0,0,0,0,0,0,0,0,0,2],
    [1,0,0,0,0,0,0,0,0,0,0,0,0,2],
    [0,0,0,0,0,0,0,0,0,0,0,0,0,2],
    [0,0,0,0,0,0,0,0,0,0,0,0,0,2],
    [0,0,0,0,0,0,0,0,0,0,0,0,1,2],
    [0,0,0,0,0,0,0,0,0,0,0,0,0,2],
    [0,0,0,0,0,0,0,0,0,0,0,0,0,2],
    [0,0,0,0,0,0,0,0,0,0,0,0,0,2],
    [1,0,0,0,0,0,0,0,0,0,0,0,0,2],
    [0,0,0,0,0,0,0,0,0,0,0,0,0,2],
    [0,0,0,0,0,0,0,0,0,0,0,0,0,2],
    [0,0,0,0,0,0,0,0,0,0,0,0,1,2],
    [0,0,0,0,0,0,0,0,0,0,0,0,0,2],
    [0,0,0,0,0,0,0,0,0,0,0,0,0,2],
    [0,0,0,0,0,0,0,"fs",0,0,0,0,0,2],
    [1,0,1,1,1,1,0,"cs",0,0,0,0,0,2],
    [0,0,0,0,0,0,0,0,0,0,0,0,0,2],
    [0,0,1,1,1,1,0,0,0,0,0,0,0,2],
    ["<<",0,0,0,0,0,0,0,0,0,0,0,1,2,0,0,0,0,0,0,0,0,0,0,0,0,0,0,0,">"]
]